亚东	Yadong
帕里	Pali
普兰	Pulan
仲巴	Zhongba
札达	Zhada
阿里	Ali
狮泉河	Shiquanhe
噶尔	Gaer
日土	Ritu
革吉	Geji
改则	Gaize
吉隆	Jilong
萨嘎	Saga
聂拉木	Nielamu
定日	Dingri
定结	Dingjie
岗巴	Gangba
拉孜	Lazi
昂仁	Angren
萨迦	Sajia
谢通门	Xietongmen
康马	Kangma
白朗	Bailang
日喀则	Rikaze
江孜	Jiangzi
仁布	Renbu
南木林	Nanmulin
申扎	Shenzha
措勤	Cuoqin
尼玛	Nima
塔什库尔干	Tashikuergan
叶城	Yecheng
皮山	Pishan
泽普	Zepu
莎车	Shache
英吉沙	Yingjisha
阿克陶	Aketao
岳普湖	Yuepuhu
麦盖提	Maigaiti
乌恰	Wuqia
疏附	Shufu
疏勒	Shule
喀什	Kashi
阿图什	Atushi
伽师	Jiashi
巴楚	Bachu
阿合奇	Aheqi
和田	Hetian
墨玉	Moyu
洛浦	Luopu
策勒	Cele
于田	Yutian
民丰	Minfeng
塔中	Tazhong
双湖	Shuanghu
且末	Qiemo
若羌	Ruoqiang
柯坪	Keping
阿瓦提	Awati
阿拉尔	Alaer
乌什	Wushi
阿克苏	Akesu
温宿	Wensu
沙雅	Shaya
拜城	Baicheng
新和	Xinhe
库车	Kuche
轮台	Luntai
昭苏	Zhaosu
霍尔果斯	Huoerguosi
察布查尔	Chabuchaer
伊宁	Yining
霍城	Huocheng
伊宁县	Yiningxian
温泉	Wenquan
特克斯	Tekesi
巩留	Gongliu
新源	Xinyuan
巴音布鲁克	Bayinbuluke
尼勒克	Nileke
博乐	Bole
精河	Jinghe
尉犁	Weili
库尔勒	Kuerle
博湖	Bohu
焉耆	Yanqi
铁干里克	Tieganlike
和静	Hejing
巴仑台	Baluntai
和硕	Shuo
小渠子	Xiaoquzi
乌苏	Wusu
奎屯	Kuitunshi
沙湾	Shawan
炮台	Paotai
呼图壁	Hutubi
石河子	Shihezi
玛纳斯	Manasi
乌鲁木齐牧试站	Wulumuqimushizhan
达坂城	Dabancheng
托克逊	Tuokexun
吐鲁番	Tulufan
乌鲁木齐	Wulumuqi
昌吉	Changji
蔡家湖	Caijiahu
米泉	Miquan
五家渠	Wujiaqu
白杨沟	Baiyanggou
天池	Tianchi
阜康	Fukang
吉木萨尔	Jimusaer
奇台	Qitai
阿拉山口	Alashankou
托里	Tuoli
裕民	Yumin
塔城	Tacheng
额敏	Emin
克拉玛依	Kelamayi
白碱滩	Baijiantan
乌尔禾	Wuerhe
莫索湾	Mosuowan
和布克赛尔	Hebukesaier
吉木乃	Jimunai
布尔津	Buerjin
福海	Fuhai
富蕴	Fuyun
哈巴河	Habahe
阿勒泰	Aletai
孟连	Menglian
勐海	Menghai
景洪	Jinghong
西沙	Xisha
勐腊	Mengla
凭祥	Pingxiang
龙州	Longzhou
三亚	Sanya
乐东	Ledong
五指山	Wuzhishan
东方	Dongfang
昌江	Changjiang
白沙	Baisha
儋州	Danzhou
保亭	Baoting
陵水	Lingshui
万宁	Wanning
琼中	Qiongzhong
屯昌	Tunchang
琼海	Qionghai
文昌	Wenchang
临高	Lingao
涠洲岛	Weizhoudao
东兴	Dongxing
宁明	Ningming
崇左	Chongzuo
上思	Shangsi
防城港	Fangchenggang
防城	Fangcheng
北海	Beihai
合浦	Hepu
钦州	Qinzhou
灵山	Lingshan
浦北	Pubei
澄迈	Chengmai
定安	Dingan
海口	Haikou
徐闻	Xuwen
雷州	Leizhou
麻章	Mazhang
湛江	Zhanjiang
赤坎	Chikan
遂溪	Suixi
廉江	Lianjiang
霞山	Xiashan
坡头	Potou
吴川	Wuchuan
化州	Huazhou
电白	Dianbai
茂港	Maogang
茂名	Maoming
博白	Bobai
陆川	Luchuan
高州	Gaozhou
信宜	Xinyi
阳西	Yangxi
阳春	Yangchun
阳江	Yangjiang
阳东	Yangdong
恩平	Enping
南沙	Nansha
中沙	Wuzhishan
台山	Taishan
开平	Kaiping
新会	Xinhui
金湾	Jinwan
斗门	Doumen
珠海	Zhuhai
错那	Cuona
瑞丽	Ruili
陇川	Longchuan
盈江	Yingjiang
梁河	Lianghe
西盟	Ximeng
沧源	Cangyuan
镇康	Zhenkang
耿马	Gengma
澜沧	Lancang
普洱	Puer
宁洱	Ninger
双江	Shuangjiang
临沧	Lincang
景谷	Jinggu
镇沅	Zhenyuan
芒市	Mangshi
德宏	Dehong
龙陵	Longling
永德	Yongde
腾冲	Tengchong
施甸	Shidian
昌宁	Changning
保山	Baoshan
凤庆	Fengqing
云县	Yunxian
景东	Jingdong
南涧	Nanjian
巍山	Weishan
六库	Liuku
怒江	Nujiang
泸水	Lushui
永平	Yongping
云龙	Yunlong
兰坪	Lanping
弥渡	Midu
大理	Dali
漾濞	Yangbi
祥云	Xiangyun
姚安	Yaoan
宾川	Binchuan
洱源	Eryuan
剑川	Jianchuan
鹤庆	Heqing
永胜	Yongsheng
福贡	Fugong
维西	Weixi
贡山	Gongshan
中甸	Zhongdian
香格里拉	Xianggelila
丽江	Lijiang
宁蒗	Ninglang
洛扎	Luozha
浪卡子	Langkazi
尼木	Nimu
贡嘎	Gongga
曲水	Qushui
札囊	Zhanang
措美	Cuomei
隆子	Longzi
琼结	Qiongjie
乃东	Naidong
泽当	Zedang
山南	Shannan
桑日	Sangri
曲松	Qusong
加查	Jiacha
堆龙德庆	Duilongdeqing
拉萨	Lasa
达孜	Dazi
林周	Linzhou
当雄	Dangxiong
墨竹工卡	Mozhugongka
朗县	Langxian
米林	Milin
墨脱	Motuo
工布江达	Gongbujiangda
嘉黎	Jiali
林芝	Linzhi
边坝	Bianba
班戈	Bange
那曲	Naqu
安多	Anduo
聂荣	Nierong
比如	Biru
索县	Suoxian
巴青	Baqing
丁青	Dingqing
杂多	Zaduo
察隅	Chayu
波密	Bomi
八宿	Basu
洛隆	Luolong
左贡	Zuogong
察雅	Chaya
贡觉	Gongjue
德钦	Deqin
得荣	Derong
乡城	Xiangcheng
稻城	Daocheng
芒康	Mangkang
巴塘	Batang
理塘	Litang
雅江	Yajiang
类乌齐	Leiwuqi
囊谦	Nangqian
昌都	Changdu
江达	Jiangda
玉树	Yushu
石渠	Shiqu
称多	Chenduo
白玉	Baiyu
德格	Dege
新龙	Xinlong
甘孜	Ganzi
道孚	Daofu
炉霍	Luhuo
色达	Seda
壤塘	Rangtang
班玛	Banma
江城	Jiangcheng
绿春	Lvchun
墨江	Mojiang
元江	Yuanjiang
石屏	Shiping
河口	Hekou
屏边	Pingbian
元阳	Yuanyang
个旧	Gejiu
红河	Honghe
建水	Jianshui
开远	Kaiyuan
蒙自	Mengzi
新平	Xinping
峨山	Eshan
玉溪	Yuxi
双柏	Shuangbai
楚雄	Chuxiong
南华	Nanhua
易门	Yimen
晋宁	Jinning
安宁	Anning
禄丰	Lufeng
太华山	Taihuashan
富民	Fumin
通海	Tonghai
华宁	Huaning
江川	Jiangchuan
弥勒	Mile
泸西	Luxi
澄江	Chengjiang
呈贡	Chenggong
石林	Shilin
宜良	Yiliang
昆明	Kunming
师宗	Shizong
陆良	Luliang
马关	Maguan
麻栗坡	Malipo
文山	Wenshan
西畴	Xichou
砚山	Yanshan
靖西	Jingxi
那坡	Napo
富宁	Funing
德保	Debao
百色	Baise
丘北	Qiubei
广南	Guangnan
西林	Xilin
罗平	Luoping
隆林	Longlin
兴义	Xingyi
田林	Tianlin
凌云	Lingyun
安龙	Anlong
册亨	Ceheng
望谟	Wangmo
乐业	Leye
牟定	Mouding
大姚	Dayao
元谋	Yuanmou
武定	Wuding
禄劝	Luquan
永仁	Yongren
华坪	Huaping
仁和	Renhe
攀枝花	Panzhihua
盐边	Yanbian
会理	Huili
会东	Huidong
嵩明	Songming
寻甸	Xundian
马龙	Malong
曲靖	Qujing
沾益	Zhanyi
东川	Dongchuan
会泽	Huize
米易	Miyi
德昌	Dechang
普格	Puge
盐源	Yanyuan
木里	Muli
凉山	Liangshan
西昌	Xichang
宁南	Ningnan
巧家	Qiaojia
鲁甸	Ludian
昭通	Zhaotong
布拖	Butuo
金阳	Jinyang
昭觉	Zhaojue
大关	Daguan
彝良	Yiliang
富源	Fuyuan
盘县	Panxian
兴仁	Xingren
普安	Puan
晴隆	Qinglong
宣威	Xuanwei
水城	Shuicheng
贞丰	Zhenfeng
关岭	Guanling
紫云	Ziyun
罗甸	Luodian
镇宁	Zhenning
六枝	Liuzhi
普定	Puding
安顺	Anshun
织金	Zhijin
长顺	Changshun
惠水	Huishui
平坝	Pingba
清镇	Qingzhen
花溪	Huaxi
小河	Xiaohe
贵阳	Guiyang
白云	Baiyun
南明	Nanming
云岩	Yunyan
乌当	Wudang
威宁	Weining
赫章	Hezhang
纳雍	Nayong
毕节	Bijie
盐津	Yanjin
镇雄	Zhenxiong
威信	Weixin
黔西	Qianxi
大方	Dafang
修文	Xiuwen
息烽	Xifeng
古蔺	Gulin
金沙	Jinsha
遵义县	Zunyixian
仁怀	Renhuai
大新	Daxin
天等	Tiandeng
扶绥	Fusui
隆安	Longan
武鸣	Wuming
田阳	Tianyang
田东	Tiandong
平果	Pingguo
大化	Dahua
马山	Mashan
南宁	Nanning
邕宁	Yongning
横县	Hengxian
贵港	Guigang
上林	Shanglin
宾阳	Binyang
合山	Heshan
来宾	Laibin
武宣	Wuxuan
巴马	Bama
凤山	Fengshan
东兰	Donglan
都安	Duan
天峨	Tiane
南丹	Nandan
河池	Hechi
环江	Huanjiang
忻城	Xincheng
宜州	Yizhou
象州	Xiangzhou
柳江	Liujiang
柳州	Liuzhou
罗城	Luocheng
柳城	Liucheng
融水	Rongshui
融安	Rongan
兴业	Xingye
玉林	Yulin
北流	Beiliu
容县	Rongxian
岑溪	Cenxi
桂平	Guiping
平南	Pingnan
藤县	Tengxian
罗定	Luoding
德庆	Deqing
新兴	Xinxing
云浮	Yunfu
云安	Yunan
高要	Gaoyao
肇庆	Zhaoqing
苍梧	Cangwu
梧州	Wuzhou
郁南	Yunan
封开	Fengkai
广宁	Guangning
金秀	Jinxiu
鹿寨	Luzhai
荔浦	Lipu
蒙山	Mengshan
昭平	Zhaoping
永福	Yongfu
临桂	Lingui
桂林	Guilin
阳朔	Yangshuo
平乐	Pingle
恭城	Gongcheng
钟山	Zhongshan
贺州	Hezhou
怀集	Huaiji
连山	Lianshan
富川	Fuchuan
江永	Jiangyong
江华	Jianghua
连南	Liannan
连州	Lianzhou
平塘	Pingtang
独山	Dushan
荔波	Libo
三都	Sandu
都匀	Duyun
龙里	Longli
贵定	Guiding
福泉	Fuquan
丹寨	Danzhai
麻江	Majiang
雷山	Leishan
凯里	Kaili
榕江	Rongjiang
从江	Congjiang
三江	Sanjiang
台江	Taijiang
黎平	Liping
锦屏	Jinping
靖州	Jingzhou
开阳	Kaiyang
瓮安	Wengan
黄平	Huangping
施秉	Shibing
余庆	Yuqing
红花岗	Honghuagang
遵义	Zunyi
汇川	Huichuan
湄潭	Meitan
绥阳	Suiyang
石阡	Shiqian
凤冈	Fenggang
思南	Sinan
剑河	Jianhe
镇远	Zhenyuan
三穗	Sansui
岑巩	Cengong
玉屏	Yuping
天柱	Tianzhu
新晃	Xinhuang
江口	Jiangkou
印江	Yinjiang
万山	Wanshan
铜仁	Tongren
芷江	Zhijiang
凤凰	Fenghuang
灵川	Lingchuan
龙胜	Longsheng
兴安	Xingan
全州	Quanzhou
通道	Tongdao
城步	Chengbu
绥宁	Suining
资源	Ziyuan
新宁	Xinning
灌阳	Guanyang
道县	Daoxian
双牌	Shuangpai
宁远	Ningyuan
蓝山	Lanshan
嘉禾	Jiahe
新田	Xintian
东安	Dongan
冷水滩	Lengshuitan
永州	Yongzhou
祁阳	Qiyang
常宁	Changning
会同	Huitong
洪江	Hongjiang
中方	Zhongfang
武冈	Wugang
洞口	Dongkou
隆回	Longhui
怀化	Huaihua
麻阳	Mayang
辰溪	Chenxi
溆浦	Xupu
邵阳县	Shaoyangxian
邵阳	Shaoyang
新邵	Xinshao
邵东	Shaodong
祁东	Qidong
衡阳县	Hengyangxian
冷水江	Lengshuijiang
新化	Xinhua
涟源	Lianyuan
娄底	Loudi
双峰	Shuangfeng
喜德	Xide
冕宁	Mianning
越西	Yuexi
九龙	Jiulong
石棉	Shimian
汉源	Hanyuan
美姑	Meigu
雷波	Leibo
永善	Yongshan
绥江	Suijiang
甘洛	Ganluo
峨边	Ebian
马边	Mabian
沐川	Muchuan
峨眉	Emei
犍为	Qianwei
康定	Kangding
泸定	Luding
丹巴	Danba
荥经	Yingjing
雅安	Yaan
天全	Tianquan
芦山	Lushan
名山	Mingshan
峨眉山	Emeishan
夹江	Jiajiang
乐山	Leshan
青神	Qingshen
洪雅	Hongya
丹棱	Danleng
蒲江	Pujiang
眉山	Meishan
彭山	Pengshan
宝兴	Baoxing
邛崃	Qionglai
大邑	Dayi
新津	Xinjin
双流	Shuangliu
崇州	Chongzhou
温江	Wenjiang
郫县	Pixian
筠连	Junlian
高县	Gaoxian
珙县	Gongxian
水富	Shuifu
宜宾县	Yibinxian
宜宾	Yibin
兴文	Xingwen
叙永	Xuyong
长宁	Changning
江安	Jiangan
纳溪	Naxi
屏山	Pingshan
荣县	Rongxian
威远	Weiyuan
南溪	Nanxi
泸州	Luzhou
泸县	Luxian
自贡	Zigong
富顺	Fushun
赤水	Chishui
合江	Hejiang
习水	Xishui
桐梓	Tongzi
荣昌	Rongchang
江津	Jiangjin
綦江	Qijiang
合川	Hechuan
巴南	Banan
井研	Jingyan
仁寿	Renshou
资阳	Ziyang
内江	Neijiang
东兴	Dongxing
资中	Zizhong
隆昌	Longchang
安岳	Anyue
龙泉驿	Longquanyi
简阳	Jianyang
成都	Chengdu
新都	Xindu
青白江区	Qibaijiang
金堂	Jintang
乐至	Lezhi
射洪	Shehong
大足	Dazu
永川	Yongchuan
铜梁	Tongliang
潼南	Tongnan
璧山	Bishan
北碚	Beibei
重庆	Chongqing
渝北	Yubei
遂宁	Suining
蓬溪	Pengxi
南充	Nanchong
武胜	Wusheng
岳池	Yuechi
华蓥	Huaying
广安	Guangan
小金	Xiaojin
金川	Jinchuan
马尔康	Maerkang
理县	Lixian
都江堰	Dujiangyan
彭州	Pengzhou
汶川	Wenchuan
黑水	Heishui
茂县	Maoxian
阿坝	Aba
红原	Hongyuan
久治	Jiuzhi
松潘	Songfan
若尔盖	Nuoergai
广汉	Guanghan
什邡	Shifang
德阳	Deyang
中江	Zhongjiang
绵竹	Mianzhu
罗江	Luojiang
安县	Anxian
绵阳	Mianyang
三台	Santai
盐亭	Yanting
梓潼	Zitong
江油	Jiangyou
北川	Beichuan
西充	Xichong
南部	Nanbu
阆中	Langzhong
蓬安	Pengan
仪陇	Yilong
营山	Yingshan
苍溪	Cangxi
剑阁	Jiange
巴中	Bazhong
旺苍	Wangcang
平武	Pingwu
文县	Wenxian
青川	Qingchuan
九寨沟	Jiuzhaigou
武都	Wudu
广元	Guangyuan
南江	Nanjiang
宁强	Ningqiang
康县	Kangxian
略阳	Lueyang
成县	Chengxian
勉县	Mianxian
正安	Zhengan
德江	Dejiang
务川	Wuchuan
万盛	Wansheng
南川	Nanchuan
道真	Daozhen
武隆	Wulong
彭水	Pengshui
秀山	Xiushan
沿河	Yanhe
松桃	Songtao
花垣	Huayuan
保靖	Baojing
酉阳	Youyang
黔江	Qianjiang
来凤	Laifeng
龙山	Longshan
长寿	Changshou
涪陵	Fuling
丰都	Fengdu
石柱	Shizhu
邻水	Linshui
垫江	Dianjiang
大竹	Dazhu
渠县	Quxian
忠县	Zhongxian
梁平	Liangping
咸丰	Xianfeng
宣恩	Xuanen
利川	Lichuan
万州	Wanzhou
恩施	Enshi
吉首	Jishou
泸溪	Luxi
沅陵	Yuanling
古丈	Guzhang
永顺	Yongshun
桑植	Sangzhi
张家界	Zhangjiajie
武陵源	Wulingyuan
安化	Anhua
桃江	Taojiang
益阳	Yiyang
赫山区	Heshanqu
桃源	Taoyuan
常德	Changde
慈利	Cili
临澧	Linli
汉寿	Hanshou
沅江	Yuanjiang
安乡	Anxiang
南县	Nanxian
鹤峰	Hefeng
五峰	Wufeng
建始	Jianshi
秭归	Zigui
三峡	Sanxia
石门	Shimen
澧县	Lixian
松滋	Songzi
津市	Jinshi
石首	Shishou
江陵	Jiangling
公安	Gongan
长阳	Changyang
宜都	Yidu
枝江	Zhijiang
宜昌	Yichang
夷陵	Yiling
当阳	Dangyang
沙市	Shashi
荆州	Jingzhou
达县	Daxian
通川	Tongchuan
达州	Dazhou
平昌	Pingchang
开江	Kaijiang
宣汉	Xuanhan
通江	Tongjiang
万源	Wanyuan
开县	Kaixian
云阳	Yunyang
奉节	Fengjie
巫溪	Wuxi
城口	Chengkou
岚皋	Langao
镇坪	Zhenping
南郑	Nanzheng
镇巴	Zhenba
西乡	Xixiang
汉中	Hanzhong
城固	Chenggu
洋县	Yangxian
留坝	Liuba
石泉	Shiquan
佛坪	Fuoping
紫阳	Ziyang
汉阴	Hanyin
安康	Ankang
平利	Pingli
旬阳	Xunyang
宁陕	Ningshan
镇安	Zhenan
柞水	Zhashui
巫山	Wushan
巴东	Badong
神农架	Shennongjia
兴山	Xingshan
竹溪	Zhuxi
竹山	Zhushan
房县	Fangxian
远安	Yuanan
掇刀	Duodao
荆门	Jingmen
保康	Baokang
谷城	Gucheng
南漳	Nanzhang
宜城	Yicheng
襄阳	Xiangyang
襄州	Xiangzhou
白河	Baihe
茅箭	Maojian
十堰	Shiyan
张湾	Zhangwan
郧西	Yunxi
郧县	Yunxian
山阳	Shanyang
丹凤	Danfeng
商南	Shangnan
老河口	Laohekou
丹江口	Danjiangkou
邓州	Dengzhou
新野	Xinye
镇平	Zhenping
淅川	Xichuan
西峡	Xixia
内乡	Neixiang
南召	Nanzhao
治多	Zhiduo
格尔木	Geermu
茫崖	Mangai
大柴旦	Dachaidan
冷湖	Lenghu
曲麻莱	Qumacai
多县	Duoxian
玛多	Madu
都兰	Dulan
达日	Dari
甘德	Gande
玛沁	Maqin
果洛	Guoluo
兴海	Xinghai
同德	Tongde
贵南	Guinan
共和	Gonghe
海南	Hainan
海西	Haixi
德令哈	Delingha
乌兰	Wulan
天峻	Tianjun
海晏	Haiyan
海北	Haibei
刚察	Gangcha
肃南	Sunan
祁连	Qilian
民乐	Minle
张掖	Zhangye
临泽	Linze
山丹	Shandan
阿克塞	Akesai
肃北	Subei
敦煌	Dunhuang
鄯善	Shanshan
木垒	Mulei
哈密	Hami
伊吾	Yiwu
巴里坤	Balikun
嘉峪关	Jiayuguan
玉门	Yumen
瓜州	Guazhou
酒泉	Jiuquan
金塔	Jinta
高台	Gaotai
额济纳	Ejina
玛曲	Maqu
河南	Henan
泽库	Zeku
碌曲	Luqu
迭部	Diebu
岷县	Minxian
临潭	Lintan
合作	Hezuo
甘南	Gannan
卓尼	Zhuoni
夏河	Xiahe
同仁	Tongren
黄南	Huangnan
循化	Xunhua
贵德	Guide
湟中	Huangzhong
尖扎	Jianzha
化隆	Hualong
平安	Pingan
海东	Haidong
乐都	Ledu
和政	Hezheng
积石山	Jishishan
临夏	Linxia
广河	Guanghe
康乐	Kangle
临洮	Lintao
东乡	Dongxiang
永靖	Yongjing
民和	Minhe
兰州	Lanzhou
皋兰	Gaolan
舟曲	Zhouqu
宕昌	Dangchang
西和	Xihe
礼县	Lixian
渭源	Weiyuan
漳县	Zhangxian
陇西	Longxi
武山	Wushan
甘谷	Gangu
徽县	Huixian
两当	Liangdang
凤县	Fengxian
天水	Tianshui
麦积	Maiji
清水	Qingshui
秦安	Qinan
张家川	Zhangjiachuan
陇县	Longxian
榆中	Yuzhong
安定	Anding
定西	Dingxi
通渭	Tongwei
会宁	Huining
白银	Baiyin
庄浪	Zhuanglang
静宁	Jingning
隆德	Longde
泾源	Jingyuan
华亭	Huating
崆峒	Kongtong
平凉	Pingliang
彭阳	Pengyang
西吉	Xiji
固原	Guyuan
湟源	Huangyuan
西宁	Xining
互助	Huzhu
大通	Datong
门源	Menyuan
武威	Wuwei
永登	Yongdeng
天祝	Tianzhu
古浪	Gulang
永昌	Yongchang
金昌	Jinchang
阿右旗	Ayouqi
民勤	Minqin
中泉子	Zhongquanzi
靖远	Jingyuan
景泰	Jingtai
平川	Pingchuan
中卫	Zhongwei
孪井滩	Luanjingtan
海原	Haiyuan
同心	Tongxin
中宁	Zhongning
头道湖	Toudaohu
锡林高勒	Xilingaole
青铜峡	Qingtongxia
吴忠	Wuzhong
灵武	Lingwu
永宁	Yongning
银川	Yinchuan
贺兰	Helan
阿左旗	Azuoqi
石嘴山	Shizuishan
陶乐	Taole
平罗	Pingluo
惠农	Huinong
太白	Taibai
宝鸡	Baoji
陈仓	Chencang
眉县	Meixian
岐山	Qishan
扶风	Fufeng
周至	Zhouzhi
武功	Wugong
杨凌	Yangling
千阳	Qianyang
凤翔	Fengxiang
麟游	Linyou
乾县	Qianxian
永寿	Yongshou
灵台	Lingtai
彬县	Binxian
户县	Huxian
兴平	Xingping
长安	Changan
西安	Xian
咸阳	Xianyang
蓝田	Lantian
临潼	Lintong
礼泉	Liquan
淳化	Chunhua
泾阳	Jingyang
三原	Sanyuan
旬邑	Xunyi
铜川	Tongchuan
耀县	Yaoxian
耀州	Yaozhou
高陵	Gaoling
富平	Fuping
渭南	Weinan
蒲城	Pucheng
崇信	Chongxin
泾川	Jingchuan
镇原	Zhenyuan
长武	Changwu
宁县	Ningxian
西峰	Xifeng
庆阳	Qingyang
合水	Heshui
庆城	Qingcheng
华池	Huachi
正宁	Zhengning
宜君	Yijun
白水	Baishui
黄陵	Huangling
洛川	Luochuan
富县	Fuxian
甘泉	Ganquan
商州	Shangzhou
商洛	Shangluo
洛南	Luonan
卢氏	Lushi
华县	Huaxian
大荔	Dali
华阴	Huayin
潼关	Tongguan
芮城	Ruicheng
灵宝	Lingbao
陕县	Shanxian
永济	Yongji
临猗	Linyi
运城	Yuncheng
栾川	Luanchuan
洛宁	Luoning
嵩县	Songxian
汝阳	Ruyang
伊川	Yichuan
三门峡	Sanmenxia
渑池	Mianchi
平陆	Pinglu
夏县	Xiaxian
义马	Yima
宜阳	Yiyang
洛阳	Luoyang
新安	Xinan
孟津	Mengjin
澄城	Chengcheng
合阳	Heyang
黄龙	Huanglong
韩城	Hancheng
万荣	Wanrong
河津	Hejin
稷山	Jishan
宜川	Yichuan
吉县	Jixian
乡宁	Xiangning
大宁	Daning
蒲县	Puxian
闻喜	Wenxi
垣曲	Yuanqu
绛县	Jiangxian
新绛	Xinjiang
侯马	Houma
曲沃	Quwo
翼城	Yicheng
阳城	Yangcheng
沁水	Qinshui
襄汾	Xiangfen
临汾	Linfen
洪洞	Hongtong
浮山	Fushan
安泽	Anze
古县	Guxian
沁源	Qinyuan
环县	Huanxian
吴起	Wuqi
盐池	Yanchi
定边	Dingbian
志丹	Zhidan
安塞	Ansai
延安	Yanan
子长	Zichang
靖边	Jingbian
河南	Henan
横山	Hengshan
鄂前旗	Eqianqi
鄂托克	Etuoke
乌审旗	Wushenqi
乌审召	Wushenzhao
延长	Yanchang
延川	Yanchuan
清涧	Qingjian
永和	Yonghe
隰县	Xixian
石楼	Shilou
绥德	Suide
子洲	Zizhou
米脂	Mizhi
吴堡	Wubu
柳林	Liulin
临县	Linxian
汾西	Fenxi
霍州	Huozhou
灵石	Lingshi
交口	Jiaokou
孝义	Xiaoyi
介休	Jiexiu
平遥	Pingyao
中阳	Zhongyang
吕梁	Lvliang
离石	Lishi
汾阳	Fenyang
方山	Fangshan
文水	Wenshui
祁县	Qixian
交城	Jiaocheng
清徐	Qingxu
古交	Gujiao
尖草坪区	Jiancaopingqu
榆林	Yulin
榆阳	Yuyang
佳县	Jiaxian
保德	Baode
伊金霍洛	Yijinhuoluo
神木	Shenmu
府谷	Fugu
娄烦	Loufan
岚县	Lanxian
兴县	Xingxian
静乐	Jingle
岢岚	Kelan
五寨	Wuzhai
宁武	Ningwu
神池	Shenchi
朔州	Shuozhou
雅布赖	Yabulai
拐子湖	Guaizihu
诺尔公	Nuoergong
吉兰太	Jilantai
乌斯泰	Wusitai
乌海	Wuhai
那仁宝力格	Narenbaolige
海力素	Hailisu
伊克乌素	Yikewusu
磴口	Dengkou
临河	Linhe
杭锦旗	Hangjinqi
乌前旗	Wuqianqi
杭锦后旗	Hangjinhouqi
乌后旗	Wuhouqi
五原	Wuyuan
大佘太	Dashetai
乌中旗	Wuzhongqi
鄂尔多斯	Eerduosi
东胜	Dongsheng
达拉特	Dalate
包头	Baotou
土右旗	Tuyouqi
河曲	Hequ
准格尔	Zhungeer
偏关	Pianguan
清水河	Qingshuihe
平鲁	Pinglu
右玉	Youyu
托县	Tuoxian
土左旗	Tuzuoqi
和林	Helin
凉城	Liangcheng
固阳	Guyang
白云鄂博	Baiyunebo
达茂旗	Damaoqi
呼和浩特	Huhehaote
武川	Wuchuan
希拉穆仁	Xilamuren
呼市郊区	Hushijiaoqu
四子王旗	Siziwangqi
满都拉	Mandula
二连浩特	Erlianhaote
江门	Jiangmen
江海	Jianghai
鹤山	Heshan
蓬江	Pengjiang
高明	Gaoming
佛山	Foshan
三水	Sanshui
南海	Nanhai
中山	Zhongshan
顺德	Shunde
番禺	Panyu
广州	Guangzhou
东莞	Dongguan
四会	Sihui
清新	Qingxin
清远	Qingyuan
花都	Huadu
增城	Zengcheng
从化	Conghua
佛冈	Fogang
深圳	Shenzhen
惠阳	Huiyang
博罗	Boluo
惠州	Huizhou
惠东	Huidong
龙门	Longmen
河源	Heyuan
东源	Dongyuan
紫金	Zijin
阳山	Yangshan
英德	Yingde
临武	Linwu
乳源	Ruyuan
曲江	Qujiang
武江	Wujiang
浈江	Zhenjiang
韶关	Shaoguan
乐昌	Lechang
仁化	Renhua
新丰	Xinfeng
翁源	Wengyuan
连平	Lianping
龙川	Longchuan
和平	Heping
始兴	Shixing
全南	Quannan
南雄	Nanxiong
龙南	Longnan
定南	Dingnan
汕尾	Shanwei
海丰	Haifeng
陆丰	Lufeng
惠来	Huilai
陆河	Luhe
揭西	Jiexi
普宁	Puning
潮阳	Chaoyang
汕头	Shantou
金平	Jinping
揭阳	Jieyang
潮安	Chaoan
丰顺	Fengshun
揭东	Jiedong
潮州	Chaozhou
澄海	Chenghai
南澳	Nanao
饶平	Raoping
诏安	Zhaoan
东山	Dongshan
五华	Wuhua
兴宁	Xingning
平远	Pingyuan
梅县	Meixian
梅州	Meizhou
大埔	Dabu
寻乌	Xunwu
安远	Anyuan
蕉岭	Jiaoling
武平	Wuping
上杭	Shanghang
云霄	Yunxiao
平和	Pinghe
南靖	Nanjing
漳浦	Zhangpu
漳州	Zhangzhou
龙海	Longhai
厦门	Xiamen
永定	Yongding
龙岩	Longyan
漳平	Zhangping
长泰	Changtai
华安	Huaan
宜章	Yizhang
桂阳	Guiyang
郴州	Chenzhou
苏仙	Suxian
汝城	Rucheng
资兴	Zixing
永兴	Yongxing
耒阳	Leiyang
安仁	Anren
炎陵	Yanling
大余	Dayu
崇义	Chongyi
上犹	Shangyou
信丰	Xinfeng
南康	Nankang
赣州	Ganzhou
赣县	Ganxian
桂东	Guidong
遂川	Suichuan
宁冈	Ninggang
万安	Wanan
衡南	Hengnan
衡阳	Hengyang
南岳	Nanyue
衡东	Hengdong
衡山	Hengshan
茶陵	Chaling
攸县	Youxian
湘乡	Xiangxiang
韶山	Shaoshan
湘潭	Xiangtan
株洲	Zhuzhou
醴陵	Liling
湘东	Xiangdong
萍乡	Pingxiang
安源	Anyuan
上栗	Shangli
永新	Yongxin
井冈山	Jinggangshan
莲花	Lianhua
泰和	Taihe
吉安县	Jianxian
安福	Anfu
吉安	Jian
吉水	Jishui
芦溪	Luxi
宜春	Yichun
万载	Wanzai
分宜	Fenyi
新余	Xinyu
会昌	Huichang
于都	Yudu
长汀	Changting
瑞金	Ruijin
兴国	Xingguo
石城	Shicheng
宁化	Ninghua
宁都	Ningdu
连城	Liancheng
永安	Yongan
大田	Datian
清流	Qingliu
明溪	Mingxi
三明	Sanming
沙县	Shaxian
永丰	Yongfeng
广昌	Guangchang
南丰	Nanfeng
峡江	Xiajiang
新干	Xingan
乐安	Anle
樟树	Zhangshu
宜黄	Yihuang
崇仁	Chongren
南城	Nancheng
抚州	Fuzhou
建宁	Jianning
泰宁	Taining
黎川	Lichuan
将乐	Jiangle
顺昌	Shunchang
邵武	Shaowu
建阳	Jianyang
资溪	Zixi
光泽	Guangze
金溪	Jinxi
武夷山	Wuyishan
同安	Tongan
石狮	Shishi
晋江	Jinjiang
泉州	Quanzhou
安溪	Anxi
南安	Nanan
惠安	Huian
崇武	Chongwu
秀屿	Xiuyu
永春	Yongchun
德化	Dehua
仙游	Xianyou
城厢	Chengxiang
秀屿港	Xiuyugang
莆田	Putian
荔城	Licheng
涵江	Hanjiang
永泰	Yongtai
福清	Fuqing
长乐	Changle
尤溪	Youxi
南平	Nanping
古田	Gutian
闽侯	Minhou
闽清	Minqing
福州	Fuzhou
连江	Lianjiang
宁德	Ningde
平潭	Pingtan
罗源	Luoyuan
建瓯	Jianou
屏南	Pingnan
政和	Zhenghe
周宁	Zhouning
松溪	Songxi
浦城	Pucheng
庆元	Qingyuan
寿宁	Shouning
龙泉	Longquan
霞浦	Xiapu
福安	Fuan
柘荣	Zherong
福鼎	Fuding
泰顺	Taishun
景宁	Jingning
云和	Yunhe
文成	Wencheng
苍南	Cangnan
平阳	Pingyang
瑞安	Ruian
温州	Wenzhou
钓鱼岛	Diaoyudao
洞头	Dongtou
宁乡	Ningxiang
望城	Wangcheng
长沙	Changsha
马坡岭	Mapoling
湘阴	Xiangyin
汨罗	Miluo
浏阳	Liuyang
平江	Pingjiang
华容	Huarong
岳阳	Yueyang
临湘	Linxiang
通城	Tongcheng
铜鼓	Tonggu
上高	Shanggao
宜丰	Yifeng
修水	Xiushui
武宁	Wuning
监利	Jianli
洪湖	Honghu
赤壁	Chibi
嘉鱼	Jiayu
潜江	Qianjiang
沙洋	Shayang
天门	Tianmen
仙桃	Xiantao
汉川	Hanchuan
崇阳	Chongyang
通山	Tongshan
咸宁	Xianning
阳新	Yangxin
梁子湖	Liangzihu
铁山	Tieshan
大冶	Daye
下陆	Xialu
黄石	Huangshi
西塞山	Xisaishan
蔡甸	Caidian
江夏	Jiangxia
东西湖	Dongxihu
孝感	Xiaogan
武汉	Wuhan
黄陂	Huangpi
鄂州	Ezhou
黄冈	Huanggang
浠水	Xishui
团风	Tuanfeng
新洲	Xinzhou
高安	Gaoan
丰城	Fengcheng
奉新	Fengxin
南昌县	Nanchangxian
新建	Xinjian
南昌	Nanchang
进贤	Jinxian
东乡	Dongxiang
余干	Yugan
靖安	Jingan
安义	Anyi
永修	Yongxiu
德安	Dean
鄱阳	Poyang
都昌	Duchang
星子	Xingzi
余江	Yujiang
鹰潭	Yingtan
贵溪	Guixi
万年	Wannian
弋阳	Yiyang
铅山	Yanshan
横峰	Hengfeng
上饶县	Shangraoxian
上饶	Shangrao
乐平	Leping
景德镇	Jingdezhen
浮梁	Fuliang
德兴	Dexing
婺源	Wuyuan
武穴	Wuxue
瑞昌	Ruichang
庐山	Lushan
九江	Jiujiang
蕲春	Qichun
黄梅	Huangmei
湖口	Hukou
宿松	Susong
彭泽	Pengze
望江	Wangjiang
罗田	Luotian
英山	Yingshan
太湖	Taihu
岳西	Yuexi
潜山	Qianshan
东至	Dongzhi
祁门	Qimen
石台	Shitai
黟县	Yixian
安庆	Anqing
怀宁	Huaining
枞阳	Zongyang
九华山	Jiuhuashan
池州	Chizhou
青阳	Qingyang
铜陵	Tongling
钟祥	Zhongxiang
京山	Jingshan
应城	Yingcheng
云梦	Yunmeng
安陆	Anlu
广水	Guangshui
枣阳	Zaoyang
随州	Suizhou
孝昌	Xiaochang
大悟	Dawu
红安	Hongan
麻城	Macheng
新县	Xinxian
信阳	Xinyang
罗山	Luoshan
光山	Guangshan
潢川	Huangchuan
唐河	Tanghe
南阳	Nanyang
桐柏	Tongbai
泌阳	Biyang
社旗	Sheqi
方城	Fangcheng
鲁山	Lushan
舞钢	Wugang
叶县	Yexian
舞阳	Wuyang
正阳	Zhengyang
确山	Queshan
驻马店	Zhumadian
汝南	Runan
息县	Xixian
平舆	Pingyu
新蔡	Xincai
遂平	Suiping
西平	Xiping
上蔡	Shangcai
漯河	Luohe
商水	Shangshui
临泉	Linquan
项城	Xiangcheng
周口	Zhoukou
淮阳	Huaiyang
沈丘	Shenqiu
郸城	Dancheng
霍山	Huoshan
商城	Shangcheng
金寨	Jinzhai
固始	Gushi
六安	Luan
霍邱	Huoqiu
桐城	Tongcheng
庐江	Lujiang
舒城	Shucheng
无为	Wuwei
巢湖	Chaohu
肥西	Feixi
合肥	Hefei
肥东	Feidong
含山	Hanshan
淮滨	Huaibin
阜南	Funan
阜阳	Fuyang
颍上	Yingshang
太和	Taihe
界首	Jieshou
利辛	Lixin
蒙城	Mengcheng
涡阳	Guoyang
寿县	Shouxian
淮南	Huainan
长丰	Changfeng
凤台	Fengtai
潘集	Panji
怀远	Huaiyuan
蚌埠	Bengbu
定远	Dingyuan
凤阳	Fengyang
明光	Mingguang
固镇	Guzhen
宿州	Suzhou
五河	Wuhe
灵璧	Lingbi
泗县	Sixian
广丰	Guangfeng
玉山	Yushan
江山	Jiangshan
松阳	Songyang
遂昌	Suichang
开化	Kaihua
常山	Changshan
衢州	Quzhou
衢江	Qujiang
龙游	Longyou
兰溪	Lanxi
建德	Jiande
丽水	Lishui
缙云	Jinyun
青田	Qingtian
永嘉	Yongjia
武义	Wuyi
金华	Jinhua
永康	Yongkang
浦江	Pujiang
义乌	Yiwu
东阳	Dongyang
磐安	Panan
仙居	Xianju
新昌	Xinchang
休宁	Xiuning
黄山	Huangshan
屯溪	Tunxi
歙县	Shexian
黄山风景区	Huangshanfengjingqu
绩溪	Jixi
淳安	Chunan
黄山区	Huangshanqu
旌德	Jingde
泾县	Jingxian
南陵	Nanling
宁国	Ningguo
广德	Guangde
桐庐	Tonglu
诸暨	Zhuji
临安	Linan
富阳	Fuyang
嵊州	Shengzhou
绍兴	Shaoxing
萧山	Xiaoshan
上虞	Shangyu
杭州	Hangzhou
德清	Deqing
安吉	Anji
湖州	Huzhou
余杭	Yuhang
海宁	Haining
桐乡	Tongxiang
嘉兴	Jiaxing
嘉善	Jiashan
乐清	Yueqing
玉环	Yuhuan
温岭	Wenling
黄岩	Huangyan
路桥	Luqiao
洪家	Hongjia
台州	Taizhou
椒江	Jiaojiang
临海	Linhai
天台	Tiantai
三门	Sanmen
宁海	Ninghai
象山	Xiangshan
奉化	Fenghua
鄞州	Yinzhou
宁波	Ningbo
余姚	Yuyao
慈溪	Cixi
镇海	Zhenhai
北仑	Beilun
定海	Dinghai
普陀	Putuo
舟山	Zhoushan
海盐	Haiyan
平湖	Pinghu
金山	Jinshan
奉贤	Fengxian
岱山	Daishan
嵊泗	Shengsi
繁昌	Fanchang
宣城	Xuancheng
芜湖县	Wuhuxian
芜湖	Wuhu
当涂	Dangtu
郎溪	Langxi
高淳	Gaochun
溧阳	Liyang
和县	Hexian
马鞍山	Maanshan
全椒	Quanjiao
滁州	Chuzhou
浦口	Pukou
江浦	Jiangpu
南京	Nanjing
溧水	Lishui
江宁	Jiangning
句容	Jurong
丹徒	Dantu
仪征	Yizheng
镇江	Zhenjiang
长兴	Changxing
宜兴	Yixing
吴江	Wujiang
吴中	Wuzhong
苏州	Suzhou
无锡	Wuxi
锡山	Xishan
金坛	Jintan
武进	Wujin
常州	Changzhou
丹阳	Danyang
扬中	Yangzhong
泰兴	Taixing
江阴	Jiangyin
张家港	Zhangjiagang
常熟	Changshu
南通	Nantong
靖江	Jingjiang
来安	Laian
盱眙	Xuyi
六合	Luhe
邗江	Hanjiang
扬州	Yangzhou
天长	Tianchang
金湖	Jinhu
高邮	Gaoyou
泗洪	Sihong
泗阳	Siyang
洪泽	Hongze
宝应	Baoying
淮安	Huaian
淮阴区	Huaiyinqu
淮安区	Huaianqu
江都	Jiangdu
泰州	Taizhou
姜堰	Jiangyan
兴化	Xinghua
如皋	Rugao
海安	Haian
东台	Dongtai
盐都	Yandu
盐城	Yancheng
建湖	Jianhu
大丰	Dafeng
松江	Songjiang
青浦	Qingpu
闵行	Minhang
徐家汇	Xujiahui
上海	Shanghai
浦东	Pudong
昆山	Kunshan
太仓	Taicang
嘉定	Jiading
宝山	Baoshan
崇明	Chongming
浦东南汇	Pudongnanhui
海门	Haimen
通州	Tongzhou
如东	Rudong
启东	Qidong
石龙	Shilong
平顶山	Pingdingshan
宝丰	Baofeng
汝州	Ruzhou
襄城	Xiangcheng
郏县	Jiaxian
许昌	Xuchang
禹州	Yuzhou
长葛	Changge
新郑	Xinzheng
偃师	Yanshi
登封	Dengfeng
巩义	Gongyi
吉利	Jili
孟州	Mengzhou
济源	Jiyuan
温县	Wenxian
沁阳	Qinyang
新密	Xinmi
荥阳	Xingyang
郑州	Zhengzhou
上街	Shangjie
武陟	Wuzhi
临颍	Linying
鄢陵	Yanling
西华	Xihua
扶沟	Fugou
尉氏	Weishi
太康	Taikang
柘城	Zhecheng
睢县	Suixian
中牟	Zhongmou
通许	Tongxu
开封	Kaifeng
原阳	Yuanyang
延津	Yanjin
封丘	Fengqiu
杞县	Qixian
民权	Minquan
兰考	Lankao
泽州	Zezhou
博爱	Boai
晋城	Jincheng
高平	Gaoping
焦作	Jiaozuo
修武	Xiuwu
获嘉	Huojia
新乡	Xinxiang
辉县	Huixian
陵川	Lingchuan
长子	Zhangzi
壶关	Huguan
长治	Changzhi
屯留	Tunliu
襄垣	Xiangyuan
平顺	Pingshun
林州	Linzhou
潞城	Lucheng
黎城	Licheng
卫辉	Weihui
淇县	Qixian
滑县	Huaxian
浚县	Xunxian
鹤壁	Hebi
长垣	Changyuan
东明	Dongming
濮阳	Puyang
汤阴	Tangyin
安阳	Anyang
峰峰	Fengfeng
磁县	Cixian
内黄	Neihuang
清丰	Qingfeng
南乐	Nanle
临漳	Linzhang
魏县	Weixian
成安	Chengan
肥乡	Feixiang
广平	Guangping
大名	Daming
馆陶	Guantao
鹿邑	Luyi
亳州	Bozhou
宁陵	Ningling
商丘	Shangqiu
虞城	Yucheng
永城	Yongcheng
夏邑	Xiayi
砀山	Dangshan
曹县	Caoxian
定陶	Dingtao
成武	Chengwu
单县	Shanxian
丰县	Fengxian
金乡	Jinxiang
鱼台	Yutai
濉溪	Suixi
淮北	Huaibei
萧县	Xiaoxian
铜山	Tongshan
徐州	Xuzhou
睢宁	Suining
邳州	Pizhou
沛县	Peixian
薛城	Xuecheng
微山	Weishan
枣庄	Zaozhuang
滕州	Tengzhou
台儿庄	Taierzhuang
峄城	Yicheng
兰陵	Lanling
菏泽	Heze
鄄城	Juancheng
郓城	Yuncheng
巨野	Juye
嘉祥	Jiaxiang
济宁	Jining
梁山	Liangshan
汶上	Wenshang
范县	Fanxian
台前	Taiqian
阳谷	Yanggu
冠县	Guanxian
莘县	Shenxian
聊城	Liaocheng
东平	Dongping
东阿	Donge
平阴	Pingyin
邹城	Zoucheng
兖州	Yanzhou
曲阜	Qufu
宁阳	Ningyang
泗水	Sishui
平邑	Pingyi
费县	Feixian
蒙阴	Mengyin
肥城	Feicheng
泰安	Taian
长清	Changqing
新泰	Xintai
莱芜	Laiwu
博山	Boshan
沁县	Qinxian
武乡	Wuxiang
榆社	Yushe
涉县	Shexian
左权	Zuoquan
太谷	Taigu
小店区	Xiaodianqu
晋中	Jinzhong
榆次	Yuci
太原	Taiyuan
寿阳	Shouyang
和顺	Heshun
昔阳	Xiyang
平定	Pingding
阳泉	Yangquan
武安	Wuan
邯郸	Handan
永年	Yongnian
沙河	Shahe
邢台	Xingtai
曲周	Quzhou
邱县	Qiuxian
南和	Nanhe
鸡泽	Jize
任县	Renxian
平乡	Pingxiang
威县	Weixian
广宗	Guangzong
巨鹿	Julu
内丘	Neiqiu
临城	Lincheng
高邑	Gaoyi
赞皇	Zanhuang
元氏	Yuanshi
隆尧	Longyao
柏乡	Baixiang
新河	Xinhe
赵县	Zhaoxian
宁晋	Ningjin
栾城	Luancheng
辛集	Xinji
阳曲	Yangqu
忻州	Xinzhou
定襄	Dingxiang
盂县	Yuxian
原平	Yuanping
代县	Daixian
五台县	Wutaixian
五台山	Wutaishan
繁峙	Fanshi
井陉	Jingxing
平山	Pingshan
鹿泉	Luquan
石家庄	Shijiazhuang
灵寿	Lingshou
正定	Zhengding
行唐	Xingtang
藁城	Gaocheng
晋州	Jinzhou
无极	Wuji
深泽	Shenze
新乐	Xinle
曲阳	Quyang
定州	Dingzhou
阜平	Fuping
唐县	Tangxian
顺平	Shunping
望都	Wangdu
涞源	Laiyuan
临西	Linxi
临清	Linqing
清河	Qinghe
夏津	Xiajin
茌平	Chiping
高唐	Gaotang
武城	Wucheng
禹城	Yucheng
平原	Pingyuan
南宫	Nangong
冀州	Jizhou
故城	Gucheng
枣强	Zaoqiang
衡水	Hengshui
武邑	Wuyi
德州	Dezhou
陵县	Lingxian
景县	Jingxian
阜城	Fucheng
吴桥	Wuqiao
东光	Dongguang
济南	Jinan
齐河	Qihe
临邑	Linyi
济阳	Jiyang
章丘	Zhangqiu
邹平	Zouping
淄川	Zichuan
周村	Zhoucun
淄博	Zibo
桓台	Huantai
高青	Gaoqing
商河	Shanghe
宁津	Ningjin
乐陵	Leling
庆云	Qingyun
惠民	Huimin
滨州	Binzhou
阳信	Yangxin
无棣	Wudi
深州	Shenzhou
安平	Anping
武强	Wuqiang
饶阳	Raoyang
安国	Anguo
博野	Boye
蠡县	Lixian
肃宁	Suning
献县	Xianxian
南皮	Nanpi
泊头	Botou
河间	Hejian
清苑	Qingyuan
保定	Baoding
满城	Mancheng
徐水	Xushui
高阳	Gaoyang
安新	Anxin
易县	Yixian
容城	Rongcheng
定兴	Dingxing
高碑店	Gaobeidian
任丘	Renqiu
雄县	Xiongxian
大城	Dacheng
文安	Wenan
霸州	Bazhou
永清	Yongqing
沧州	Cangzhou
沧县	Cangxian
盐山	Yanshan
孟村	Mengcun
青县	Qingxian
黄骅	Huanghua
海兴	Haixing
静海	Jinghai
津南	Jinnan
西青	Xiqing
天津	Tianjin
东丽	Dongli
北辰	Beichen
大港	Dagang
塘沽	Tanggu
汉沽	Hangu
宁河	Ninghe
宿迁	Suqian
宿豫	Suyu
新沂	Xinyi
沭阳	Shuyang
涟水	Lianshui
灌南	Guannan
灌云	Guanyun
郯城	Tancheng
东海	Donghai
临沂	Linyi
临沭	Linshu
连云港	Lianyungang
赣榆	Ganyu
阜宁	Funing
滨海	Binhai
响水	Xiangshui
射阳	Sheyang
沂南	Yinan
沂水	Yishui
莒南	Junan
日照	Rizhao
莒县	Juxian
五莲	Wulian
沂源	Yiyuan
临朐	Linqu
诸城	Zhucheng
安丘	Anqiu
黄岛	Huangdao
高密	Gaomi
胶州	Jiaozhou
青岛	Qingdao
崂山	Laoshan
即墨	Jimo
青州	Qingzhou
临淄	Linzi
昌乐	Changle
寿光	Shouguang
广饶	Guangrao
博兴	Boxing
潍坊	Weifang
昌邑	Changyi
利津	Lijin
东营	Dongying
垦利	Kenli
沾化	Zhanhua
河口	Hekou
平度	Pingdu
莱州	Laizhou
莱西	Laixi
莱阳	Laiyang
招远	Zhaoyuan
栖霞	Qixia
龙口	Longkou
蓬莱	Penglai
长岛	Changdao
曹妃甸	Caofeidian
唐海	Tanghai
海阳	Haiyang
乳山	Rushan
文登	Wendeng
福山	Fushan
牟平	Mouping
烟台	Yantai
威海	Weihai
石岛	Shidao
荣成	Rongcheng
成山头	Chengshantou
旅顺	Lvshun
大连	Dalian
金州	Jinzhou
长海	Changhai
山阴	Shanyin
应县	Yingxian
左云	Zuoyun
怀仁	Huairen
浑源	Hunyuan
大同县	Datongxian
丰镇	Fengzhen
大同	Datong
阳高	Yanggao
察右前旗	Chayouqianqi
灵丘	Lingqiu
广灵	Guangling
蔚县	Yuxian
阳原	Yangyuan
天镇	Tianzhen
怀安	Huaian
涿鹿	Zhuolu
万全	Wanquan
宣化	Xuanhua
卓资	Zhuozi
集宁	Jining
察右中旗	Chayouzhongqi
察右后旗	Chayouhouqi
兴和	Xinghe
商都	Shangdu
尚义	Shangyi
张家口	Zhangjiakou
崇礼	Chongli
张北	Zhangbei
化德	Huade
康保	Kangbao
太仆寺	Taibusiqi
涞水	Laishui
涿州	Zhuozhou
固安	Guan
廊坊	Langfang
房山	Fangshan
大兴	Daxing
石景山	Shijingshan
丰台	Fengtai
门头沟	Mentougou
海淀	Haidian
北京	Beijing
朝阳	Chaoyang
通州	Tongzhou
怀来	Huailai
延庆	Yanqing
昌平	Changping
顺义	Shunyi
怀柔	Huairou
武清	Wuqing
宝坻	Baodi
香河	Xianghe
大厂	Dachang
三河	Sanhe
蓟县	Jixian
丰南	Fengnan
玉田	Yutian
密云	Miyun
平谷	Pinggu
遵化	Zunhua
兴隆	Xinglong
赤城	Chicheng
丰宁	Fengning
沽源	Guyuan
多伦	Duolun
滦平	Luanping
承德	Chengde
隆化	Longhua
围场	Weichang
朱日和	Zhurihe
苏右旗	Suyouqi
镶黄旗	Xianghuang
正镶白旗	Zhengxiangbaiqi
苏左旗	Suzuoqi
阿巴嘎	Abaga
正蓝旗	Zhenglanqi
克什克腾	Keshiketeng
锡林浩特	Xilinhaote
林西	Linxi
西乌旗	Xiwuqi
唐山	Tangshan
滦南	Luannan
丰润	Fengrun
滦县	Luanxian
迁安	Qianan
乐亭	Leting
昌黎	Changli
卢龙	Lulong
抚宁	Funing
北戴河	Beidaihe
迁西	Qianxi
承德县	Chengdexian
宽城	Kuancheng
青龙	Qinglong
秦皇岛	Qinhuangdao
绥中	Suizhong
兴城	Xingcheng
葫芦岛	Huludao
平泉	Pingquan
凌源	Lingyuan
八里罕	Balihan
喀喇沁	Kalaqin
宁城	Ningcheng
建昌	Jianchang
喀左	Kazuo
建平县	Jianpingxian
朝阳	Chaoyang
北票	Beipiao
普兰店	Pulandian
瓦房店	Wafangdian
营口	Yingkou
庄河	Zhuanghe
盖州	Gaizhou
大石桥	Dashiqiao
岫岩	Xiuyan
锦州	Jinzhou
凌海	Linghai
大洼	Dawa
盘锦	Panjin
盘山	Panshan
义县	Yixian
北镇	Beizhen
黑山	Heishan
阜新	Fuxin
海城	Haicheng
鞍山	Anshan
台安	Taian
弓长岭	Gongchangling
辽阳县	Liaoyangxian
辽阳	Liaoyang
灯塔	Dengta
辽中	Liaozhong
新民	Xinmin
沈阳	Shenyang
岗子	Gangzi
赤峰	Chifeng
巴林右旗	Balinyouqi
翁牛特	Wengniute
敖汉	Aohan
宝国吐	Baoguotu
奈曼	Naiman
巴林左旗	Balinzuoqi
浩尔吐	Haoertu
阿鲁旗	Aluqi
扎鲁特	Zhalute
青龙山	Qinglongshan
库伦	Kulun
彰武	Zhangwu
法库	Faku
调兵山	Diaobingshan
康平	Kangping
科左后旗	Kezuohouqi
双辽	Shuangliao
开鲁	Kailu
通辽	Tongliao
舍伯吐	Shebotu
高力板	Gaoliban
科左中旗	Kezuozhongqi
通榆	Tongyu
东港	Donggang
丹东	Dandong
凤城	Fengcheng
宽甸	Kuandian
本溪	Benxi
本溪县	Benxixian
抚顺	Fushun
章党	Zhangdang
新宾	Xinbin
清原	Qingyuan
桓仁	Huanren
集安	Jian
通化县	Tonghuaxian
通化	Tonghua
白山	Baishan
临江	Linjiang
江源	Jiangyuan
东岗	Donggang
长白	Changbai
铁岭	Tieling
开原	Kaiyuan
昌图	Changtu
西丰	Xifeng
辽源	Liaoyuan
四平	Siping
梨树	Lishu
东辽	Dongliao
公主岭	Gongzhuling
柳河	Liuhe
梅河口	Meihekou
东丰	Dongfeng
辉南	Huinan
伊通	Yitong
双阳	Shuangyang
磐石	Panshi
长岭	Changling
前郭	Qianguo
长春	Changchun
九台	Jiutai
永吉	Yongji
吉林	Jilin
农安	Nongan
德惠	Dehui
扶余	Fuyu
榆树	Yushu
靖宇	Jingyu
抚松	Fusong
桦甸	Huadian
和龙	Helong
敦化	Dunhua
安图	Antu
蛟河	Jiaohe
舒兰	Shulan
五常	Wuchang
龙井	Longjing
延吉	Yanji
珲春	Hunchun
图们	Tumen
汪清	Wangqing
宁安	Ningan
海林	Hailin
牡丹江	Mudanjiang
穆棱	Muling
东宁	Dongning
绥芬河	Suifenhe
青河	Qinghe
东乌旗	Dongwuqi
新右旗	Xinyouqi
满洲里	Manzhouli
乌拉盖	Wulagai
霍林郭勒	Huolinguole
巴雅尔吐胡硕	Bayaertuhushuo
阿尔山	Aershan
科右中旗	Keyouzhongqi
突泉	Tuquan
科右前旗	Keyouqianqi
乌兰浩特	Wulanhaote
洮南	Taonan
白城	Baicheng
镇赉	Zhenlai
泰来	Tailai
索伦	Suolun
胡尔勒	Huerle
扎赉特	Zhalaite
龙江	Longjiang
新左旗	Xinzuoqi
鄂温克旗	Ewenkeqi
海拉尔	Hailaer
陈旗	Chenqi
牙克石	Yakeshi
额尔古纳	Eerguna
博克图	Boketu
扎兰屯	Zhalantun
阿荣旗	Arongqi
小二沟	Xiaoergou
图里河	Tulihe
根河	Genhe
呼中	Huzhong
漠河	Mohe
乾安	Qianan
大安	Daan
松原	Songyuan
肇源	Zhaoyuan
肇州	Zhaozhou
双城	Shuangcheng
安达	Anda
哈尔滨	Haerbin
肇东	Zhaodong
兰西	Lanxi
杜尔伯特	Duerbote
大庆	Daqing
齐齐哈尔	Qiqihaer
林甸	Lindian
青冈	Qinggang
望奎	Wangkui
明水	Mingshui
拜泉	Baiquan
阿城	Acheng
尚志	Shangzhi
呼兰	Hulan
宾县	Binxian
巴彦	Bayan
延寿	Yanshou
木兰	Mulan
方正	Fangzheng
通河	Tonghe
绥化	Suihua
庆安	Qingan
绥棱	Suiling
海伦	Hailun
铁力	Tieli
伊春	Yichun
富裕	Fuyu
莫力达瓦	Molidawa
讷河	Nehe
依安	Yian
克山	Keshan
克东	Kedong
北安	Beian
嫩江	Nenjiang
五大连池	Wudalianchi
鄂伦春旗	Elunchunqi
加格达奇	Jiagedaqi
大兴安岭	Daxinganling
五营	Wuying
孙吴	Sunwu
黑河	Heihe
逊克	Xunke
林口	Linkou
依兰	Yilan
勃利	Boli
桦南	Huanan
鸡东	Jidong
鸡西	Jixi
密山	Mishan
七台河	Qitaihe
汤原	Tangyuan
佳木斯	Jiamusi
桦川	Huachuan
鹤岗	Hegang
集贤	Jixian
双鸭山	Shuangyashan
友谊	Youyi
萝北	Luobei
绥滨	Suibin
富锦	Fujin
宝清	Baoqing
虎林	Hulin
同江	Tongjiang
饶河	Raohe
乌伊岭	Wuyiling
嘉荫	Jiayin
抚远	Fuyuan
新林	Xinlin
塔河	Tahe
呼玛	Huma
